##############
#   # .......#
# A.# .#####.#
#  ....#  ##.#
######### #..#
#       .B#.##
# ######. #..#
#   #  #.###.#
#   #   .....#
##############
