##############
#   # .......#
# A # .#####.#
# .....#  ##.#
######### #..#
#       .B#.##
# ######. #..#
#   #  #.###.#
#   #   .....#
##############
